...###
..##&#.####
.##..###.&#
##........#
#...@..#..#
###..###..#
..#..#...&#
.##.##.#.##
.#&.....##
.#..&..##
.#######