...###
..##&#.###
.##..###.&
##........
#...@..#..
###..###..
..#..#...&
.##.##.#*#
.#&.....##
.#..&..##