#..###....
#.&...###.
#..#....#.
#......###
&#..@.....
.#.......#
.......#..
*##...&.#
#&.......#
#...###&..