#..###....
#.&...###.
#..#....#.
#......###
&#...@....
.#.......#
.......#..
*##...&.#
#&.......#
#...###&..