....###...
.*#....&.#
.##.......
.&....###.
##..@.#&..
.......#..
.#........
.#...#..&.
.#...#..##
&####.####