....###...
.*#....&.#
.##.......
.&....###.
##....#&..
.......#..
.#........
.#...#..&.
.#@..#..##
&####.####