.........#
##.....#.&
#&......##
###.......
.&#.......
.........#
###....&##
*&#....#@#
..#....#.#
.........#