.........#
##.....#.&
#&......##
###.......
.&#.@.....
.........#
###....&##
*&#....#.#
..#....#.#
.........#