.&.&.&.&.&
&.........
.....#...&
&...###...
....@....&
&.........
...###...&
&...#.....
*........&
&.&.&.&.&.